1111111111111
1000100000101
1000000P00001
1C00000C00001
1E000000CC001
1111111111111