1111111111111
1000100000101
100000P000001
1C00000C00001
1E000000CC001
1111111111111
