
1111111111111
1000101100001
10C0000P01101
1C11101C01101
1E000010CC1C1
1111111111111