1111111111111
1000101100001
10C0000P01101
1C11101CP1101
1EE00010CC1C1
1111111111111
